{{1, 1, 1, 1, 1, 1, 1, 1, 1, 1, 1, 1, 1, 1, 1, 1, 1, 1, 1, 1, 1, 1, 1, 1, 1, 1, 1, 1, 1, 1},
{1, 3, 3, 3, 3, 3, 3, 3, 3, 3, 3, 3, 3, 1, 3, 3, 3, 3, 3, 3, 1, 3, 3, 3, 3, 3, 3, 3, 3, 1},
{1, 3, 1, 1, 1, 1, 3, 1, 3, 1, 1, 1, 3, 1, 3, 1, 1, 1, 1, 3, 1, 3, 1, 1, 1, 1, 1, 1, 3, 1},
{1, 3, 1, 1, 3, 3, 3, 1, 3, 1, 1, 1, 3, 1, 3, 1, 1, 1, 1, 3, 3, 3, 3, 3, 1, 0, 0, 1, 3, 1},
{1, 3, 1, 1, 3, 1, 1, 1, 3, 3, 3, 3, 3, 1, 3, 1, 1, 1, 1, 3, 1, 1, 1, 3, 1, 2, 2, 1, 3, 1},
{1, 3, 1, 3, 3, 3, 3, 3, 3, 1, 1, 3, 1, 1, 3, 3, 3, 3, 1, 3, 1, 1, 1, 3, 1, 5, 1, 1, 3, 1},
{1, 3, 1, 3, 1, 3, 1, 1, 1, 1, 1, 3, 3, 3, 3, 1, 1, 3, 3, 3, 1, 1, 1, 3, 3, 3, 3, 1, 3, 1},
{1, 3, 3, 3, 1, 3, 3, 3, 3, 3, 3, 3, 1, 1, 3, 1, 1, 1, 3, 1, 1, 1, 1, 3, 1, 1, 3, 1, 3, 1},
{1, 3, 1, 1, 1, 3, 1, 1, 1, 1, 3, 1, 1, 4, 3, 1, 1, 1, 3, 3, 3, 3, 3, 3, 3, 3, 3, 3, 3, 1},
{1, 7, 3, 3, 3, 3, 1, 1, 1, 1, 3, 3, 3, 3, 1, 1, 1, 1, 1, 3, 1, 1, 1, 1, 3, 1, 1, 1, 1, 1},
{1, 1, 1, 1, 1, 3, 1, 1, 1, 1, 3, 1, 1, 1, 1, 1, 3, 3, 3, 3, 1, 1, 1, 1, 3, 3, 3, 3, 3, 1},
{1, 3, 3, 3, 3, 3, 3, 3, 3, 3, 3, 3, 1, 1, 1, 3, 3, 1, 1, 3, 1, 1, 1, 1, 3, 1, 1, 1, 3, 1},
{1, 3, 1, 3, 1, 1, 3, 1, 1, 1, 1, 3, 1, 1, 1, 3, 1, 1, 3, 3, 3, 3, 3, 3, 3, 1, 3, 3, 3, 1},
{1, 3, 1, 3, 3, 3, 3, 1, 1, 1, 3, 3, 3, 1, 1, 3, 3, 3, 3, 1, 1, 1, 1, 1, 3, 1, 3, 1, 3, 1},
{1, 3, 1, 1, 5, 1, 3, 1, 1, 1, 3, 1, 3, 3, 3, 3, 1, 1, 3, 1, 1, 3, 3, 3, 3, 3, 3, 1, 3, 1},
{1, 3, 1, 2, 2, 1, 3, 1, 1, 1, 3, 1, 1, 1, 1, 3, 1, 3, 3, 3, 3, 3, 1, 1, 1, 3, 1, 1, 3, 1},
{1, 3, 1, 0, 0, 1, 3, 3, 3, 3, 3, 1, 1, 1, 1, 3, 1, 3, 1, 1, 1, 3, 1, 3, 3, 3, 1, 1, 3, 1},
{1, 3, 1, 1, 1, 1, 1, 1, 3, 1, 3, 1, 1, 1, 1, 3, 1, 3, 1, 1, 1, 3, 1, 3, 1, 1, 1, 1, 3, 1},
{1, 3, 3, 3, 3, 3, 3, 3, 3, 1, 3, 3, 3, 3, 3, 3, 1, 3, 3, 3, 3, 3, 3, 3, 3, 3, 3, 3, 3, 1},
{1, 1, 1, 1, 1, 1, 1, 1, 1, 1, 1, 1, 1, 1, 1, 1, 1, 1, 1, 1, 1, 1, 1, 1, 1, 1, 1, 1, 1, 1}}